26
24
5T8888888888888888888889
5WWWWWWWWWWWWWWWWWWWWWWW
5Ssa_01________________W
5bcd___________________W
5____________0123______W
5____________4eW5______W
5____________6WW711____W
5______________________W
5W_____________________W
5W____ff_______________W
5W_____________________W
5W_____________________W
5______________________W
5______________________W
5______________________W
5______________________W
5__________________L___W
5__________________l___W
5______________________W
5______________________W
5______________________W
5______________________W
5T89___________________W
5WWW___________________W
5WWW___________________W
5T8888888888888888888889

