19
37
WWWWWWWWWWWWWWWWWWWWWWWWWWWWWWWWWWWWW
WWWWWWWWWWWWWWWWWWWWWWWWWWWWWWWWWWWWW
WWWWWWWWWWWWeWWeWWeWWeWWeWWeWWe______
WWWe5____gWWWWWWWWW__________________
WWWW5________________________________
WWWe5_Z_______________________C______
WWWW5ZZ___C___________________C__.___
WWWW723_CCCE____._.______E____0123___
WWWWWW71111111123_0111111111116WW5___
WWWWWWWWWWWWWWWW5L4WWWWWWWWWWWWeW5___
WWWWWWWWWWWWWWWW5l4WWWWWWWWWWWWWW5ZC_
WWWWWWWWWWWWWWWW5l4WW5_____gWWWW7123_
WWWe5_____gWWWWW5lgWW5_________gWWW5_
WWWW5_________Z__l________023________
WWWe5____________l________4W723______
WWWW723P_______HC_____E___4WWW723____
WWWWWW711111111111111111116WWWWW72222
WWWWWWWWWWWWWWWWWWWWWWWWWWWWWWWWWWWWW
WWWWWWWWWWWWWWWWWWWWWWWWWWWWWWWWWWWWW





